38,41,44,46,48,50,52,55,58,61
35,38,42,51,52,53,55,58,61,64
33,36,40,50,82,78,74,72,64,66
31,37,44,88,86,70,70,71,70,68
28,36,54,90,70,70,70,72,78,75
26,35,44,92,94,70,70,71,68,70
23,27,34,90,96,70,80,70,60,65
20,18,24,90,98,100,90,90,50,57
17,16,15,14,100,100,100,30,40,48
16,14,13,12,11,10,15,20,30,39
