25,15,10,5,0,10,15,20,15,10
35,30,15,5,0,5,6,25,20,15
40,25,20,12,0,0,8,30,35,30
45,33,25,16,10,0,10,25,40,45
50,40,30,20,10,0,20,30,40,50
48,42,36,28,19,0,10,30,39,48
46,44,38,32,27,10,20,32,44,46
44,42,40,34,31,30,30,40,42,44
42,40,38,36,38,40,36,38,40,42
40,38,36,34,36,34,34,36,38,40
