56,52,48,44,40,39,39,44,46,44
52,48,44,40,39,39,42,46,48,46
48,44,40,39,40,38,38,42,46,42
44,40,39,40,40,40,37,37,44,42
40,39,40,40,44,40,38,36,42,40
39,39,36,40,40,36,34,36,38,38
39,36,32,34,34,34,32,30,32,34
36,32,30,28,30,30,30,28,26,28
32,30,30,28,28,30,32,26,24,22
28,29,29,29,29,32,34,30,22,20
