0,0,1,1,x,1,1,1,0,0
1,1,1,1,1,1,0,1,0,0
1,1,1,0,X,X,0,1,1,0
1,0,0,0,1,1,1,0,1,1
G,1,1,1,1,X,1,1,1,S
1,0,0,0,0,X,0,0,0,1
1,0,0,0,0,X,X,0,0,1
1,0,0,0,0,0,X,0,0,1
1,1,0,0,0,0,0,0,1,1
0,1,1,1,1,1,1,1,1,0
